123456789012345678901234567890
11111111111111111111111111111111
1                              1
1      8                       1
1             1111111111111111 1             
111111111111111            1   1                
1                11111111191   1
1 11111111111111 1       111   1
1   1          1 11            1
1         111111  11111111 111 1
1   1     1              1 1 1 1
1   1     1111111111111111 1 1 1
1   1                      1 1 1
1   111111111111111111111111 1 1
1                            1 1
1 111  111111111111111       1 1
1 1 1  1             1 1111111 1
1 1 1  111111111 111 1 1       1 
1 1 1          1 1 111 1111111 1
1 1 111111111111 1           1 1
1 1              1111111111111 1
1 1    111111111               1
1 111111       1     11111 111 1
1         111111     1   1 1 1 1
1   1111111          1   111 1 1
1   1       1111111111       1 1
1 111       11               1 1
1 1          1  111 1111111111 1
1 111111111111  1 111          1
1               1              1
1    111111111111              1
1                              1
11111111111111111111111111111111
										  
					
					
								